-c------=
-       ?
/   -   -
-   $   *
-   1   -
-       p
--P------

SimplePizza

7 2
1 3
1 5
3 4